11111111
1100E001
10100001
1001C001
10001001
10000101
10P00011
11111111
