11111111
11000001
10100001
1001C001
10001001
10000101
10000011
11111111
