111111111111111
1100000C10011E1
10000000C000001
1C00000110C0V01
1C00000000P0001
1C00V00000C0001
111111111111111