11111111111111111111111111111111111111
10000000C0000P0000000000000C0000001111
10010111110000011111001011111000001111
10010000C000010111110010000C0000P01111
1001000000000E011111001000000000001111
10001111101100000C110001111101100000C1
11111111111111111111111111111111111111